9
9
*005/500*
558505855
*6000006*
250000052
5510S0155
050000050
050000050
555757555
050353050