9
9
S55555555
3800002*5
055555555
0700011*5
055555555
06123***5
055555555
060708060
05555555/