9
9
00*505*00
556505655
0500/0050
*70000070
5520S0255
063000360
051000150
555858555
050050050