9
9
0005/5000
556505655
050000050
070000070
5520S0255
063000360
051000150
555858555
050050050