9
9
555555555
5/8030805
555556505
508351725
5*5856505
515350605
565756565
500200610
55555550S