333131333
333131333
111131111
333323333
111131111
333131333
333131333